

C 177 , 201 , 255
R 1920  1080
NO  textures/wall1h.xpm
SO  textures/wall1v.xpm
WE  textures/wall2h.xpm
EA  textures/wall2v.xpm


S      textures/metal_barrel.xpm
F 139, 69, 19






        1111111111111111111111111
        1000000000112000002000001
        1011000001110000002200001
        1001000000000000000000001
111111111011000001110000000000001
100000000011000001110111100111111
11110111111001011100002010001
11110111111100111010100000001
11010100110101011100000010001
10010100002000000000000010N01
1100000000000001111101111000111
1111011111110101 101111010001
11111111 1111111 111111111111
