

C 225,30, 0
R 1920  1080
NO                          ../textures/cat.xpm
SO     ../textures/cat.xpm



WE ../textures/cat.xpm
EA           ../textures/cat.xpm


S      ../textures/cat.xpm
F 255, 241,5

        1111111111111111111111111
        1100000011110000000000001
111111111011000001110000002000001
100100000000000000000000111111111
111111111011000001110000000000001
100000000011000001110111111111111
11110111111111011100000010001
11110111111111011101010010001
11000000110101011100000010001
10002000000000001100000000001
10000000000000001101010010001
11000001110101011111011110N0111
11110111 1110101 101111010001
11111111 1111111 111111111111

1111111
1112111
111 111

11111111
