

C 177 , 201 , 255
R 1920  1080
NO                          textures/cat.xpm
SO     textures/cat.xpm



WE textures/cat.xpm
EA           textures/cat.xpm


S      textures/cat.xpm
F 139, 69, 19

        1111111111111111111111111
        1000000000110000000000001
        1011000001110000002000001
        1001000000000000000000001
111111111011000001110000000000001
100000000011000001110111100111111
11110111111111011100000010001
11110111111111011101010000001
11000000110101011100000010001
10002000000000001100000010001
11000001110101011111011110E0111
11110111 1110101 101111010001
11111111 1111111 111111111111
