C 177 , 201 , 255
R 1920  1080
NO  textures/wall1h.xpm
SO  textures/ceil1.xpm
WE  textures/wall2h.xpm
EA  textures/ceil4.xpm

S      textures/barrel.xpm
F 139, 69, 19




        1111111111111111111111111
        1000000000112000002000001
        1011000001110000002200001
        10010000000000000000000011
1111111111011000001110000000000001
1000000000110000011101111001111111
11110111111001011100002010001
11110111111100111010100000001
11010100110101011100000010001
10010100002000000000000010N01
1100000000000001111101111000111
1111011111110101 101111010001
111111111 111111 111111111111
